X X X X X X X X X X X X X X X X X
X X X X X - - - P - - - X X X X X
X X X - - - - - - - - - - - - X X
X X - - - - - - - - - - - - - X X
X X - - X - - - - - - - X X X X X
X X - - X X X X X X X X X X X X X
X X - - X X X F F X X X X X X X X
X X - - X - - - - X X X X X X X X
X X - - - - - - X X X X X X X X X
X X X - - - - X X X X X X X X X X
X X X X X X X X X X X X X X X X X
