X X X X X X X X X X X
X X - - - X X - - X X
X - - - - - - - - F X
X P - - X X X - - F X
X P - - - X X - - F X
X - - - - - - - - F X
X X X X - - - - X X X
X X X X X X X X X X X
